13 11 11 11 11 11 11 11 11 11 11 11 11 11 12
9  1  0  0  2  0  0  0  0  0  0  0  1  0  8
9  0  0  3  1  27 22 26 0  0  1  0  0  2  8
9  0  0  0  27 29 5  28 26 0  0  0  0  0  8
9  0  2  0  20 6  5  7  21 0  0  2  0  1  8
9  0  2  0  24 31 5  30 25 0  0  0  0  1  8
9  1  3  2  0  24 23 25 0  0  0  0  0  0  8
9  0  0  1  0  0  0  0  0  0  0  2  0  1  8
9  0  0  1  0  0  0  0  0  0  0  2  0  1  8
14 10 10 10 10 10 10 10 10 10 10 10 10 10 15